10
 79  64   1  72  86  67  44  12   7  81
  3  33  75  14   6  74  43  47  38  42
 71  17  82  70  63  11  23  21  99  85
 29  59  37  87   5  98   0  69  90  92
 56  58   8  57  16  35  84  15  65  73
 48  76  62  24  10  32  26  27  13  91
 28  78  55  25   9  36  31  96  45   2
 60  97  61  18  66  41  80  88   4  20
 39  77  34  68  30  95  46  53  19  89
 94  50  40  83  54  49  22  51  93  52
