8
44 60 50 31 12 22 21  4
13 47 32 27  6 38 23 52
11  0 28 53 34 24 54  1
58 26 46 14 42 17 39 56
 7 63 48 59 36  5 57 61
29 62 30 40 49 35 16 15
51 19  8  2 45 33 18 41
10 25  3 20  9 37 43 55
