9
 1  5 68 41 19 66 70  3 47
75 61 59 11 36 34 54 76  6
62 28 31 17 60 37 25 35 44
65 71 50  8 58 40 30 39 45
27 46  2 77 69 43 57 63 29
 9 24 33 51 67 72 64 56 49
73 79 42 22  4 32 80  7 48
21 20 18  0 23 55 53 14 13
12 38 74 78 52 10 26 16 15
