10
 40  90  56  45  93  46  36   6  10  59
 84  73   1  69   0  82  72  11  41  92
 32  66  54  23  70  26  43  15   4  87
 67  65  95  96  12  35  42  75  52  39
 86   3  13  55  19  16  91  71   2  17
 83  33  88  34  74  57   9  85  30   8
 97   5  27  98  99  31  25  60  78  81
  7  63  77  76  44  48  51  50  47  61
 37  58  89  68  29  64  62  18  79  14
 38  94  53  28  20  22  80  21  49  24
