8
50 51 17 61 31 35 54 56
 5 40 18 46 29 41 57 36
30 38  7 42  9 63 52 26
45  6 32  8 12 59 21 14
49  2 23 43 33 48 22 15
 0  1 34 55 11 60 13 27
 3 28 19 62 24 47 20 53
37 44  4 25 10 16 58 39
