9
59 66 71 62  7  8 29 57 73
31 76 54  2 55 56 72  1 63
79 70 46 40 10 34 32 65 18
15 38  5 51  4 21 35 24  9
49 11 22 33 75 53 30 13 36
43 60 50 26 44  0 47 14 58
 6 74 16 64 27 77 67 42 17
78 25 69 28 68 48 20 39 45
12  3 80 37 41 23 52 61 19
